# *DO NOT DIRECTLY EDIT THIS FILE, IT IS AUTOMATICALLY GENERATED AND IT IS BASED ON:*
# https://docs.google.com/spreadsheet/ccc?key=0AmQEO36liL4FdDJLWVNMaVV2UmRKSnpXU09MYkdGbEE
aboutDrawio=Tentang draw.io
access_denied=Akses ditolak
actualSize=Ukuran Aktual
addToExistingDrawing=Tambah ke gambar yang ada
addWaypoint=Add waypoint
align=Rata
alignment=Perataan
allChangesLost=Semua perubahan akan hilang!
alreadyConnected=Node-node telah terhubung
apply=Terapkan
arrange=Atur
appNotInstalledAlert=App belum diinstalasi. Pasang draw.io dalam Chrome Web Store lalu coba lagi.
appNotInstalledStatus=App belum diinstalasi.
arrow=Panah
arrows=Panah-panah
automatic=Automatic
autosize=Ukuran Otomatis
backgroundColor=Warna Latar
basic=Dasar
blankDrawing=Gambar Kosong
block=Blok
bold=Tebal
borderColor=Warna border
borderWidth=Lebar border
bottom=Bawah
bottomAlign=Rata Bawah
cancel=Batal
center=Tengahkan
cannotLoad=Load attempts failed. Please try again later.
cannotLogin=Log in attempts failed. Please try again later.
changeOrientation=Ubah Orientasi
chatJoined={1} has joined
chatLeft={1} has left
chatWindowTitle=Chat
circle=Lingkaran
classic=Klasik
clipart=Grafik Klip
close=Tutup
collapse=Persempit
collapse-expand=Perlebar/Persempit
connect=Hubungi
connecting=Menghubungi
connectWithDrive=Hubungi Google Drive
connection=Koneksi
containsValidationErrors=Berisi error validasi
copy=Salin
copyConnect=Copy on connect
copyOfDrawing=Salinan Gambar
curved=Curved
custom=Kustom
cut=Potong
dashed=Bergaris
delete=Hapus
diamond=Permata
diamondThin=Permata (Tipis)
didYouKnow=Tahukah anda...
direction=Arah
done=Selesai
doubleClickOrientation=Klik ganda untuk ubah orientasi
drawing=Gambar {1}
drawingEmpty=Gambar kosong
drawingTooLarge=Gambar terlalu besar
duplicate=Duplikat
east=Timur
edit=Edit
editLink=Edit tautan
embed=Embed
embedNotice=Tambah sekali ke akhir halaman
enterGroup=Masukkan grup
enterValue=Masukkan nilai
entityRelation=Relasi Entitas
error=Error
errorLoadingFile=Error memuat file
errorRenamingFile=Error renaming file.
errorRenamingFileNotFound=Error renaming file. File was not found.
errorRenamingFileForbidden=Error renaming file. Insufficient access rights.
errorSavingFile=Error menyimpan file
errorSavingFileForbidden=Error saving file. Insufficient access rights.
errorSavingFileNotFound=Error saving file. File was not found.
exitGroup=Keluar Grup
expand=Perluas
export=Ekspor
failedToSaveTryReconnect=Gagal menyimpan, coba menghubungi ulang
featureRequest=Feature Request
feedback=Feedback
file=File
filename=Nama file
fileNotFound=File tidak ditemukan
fileNotLoaded=File tidak dimuat
fileNotSaved=File tidak disimpan
fileOpenLocation=How would you like to open these file(s)?
fillColor=Isi warna
fit=Paskan
fitPage=Paskan dengan halaman
fitPageWidth=Paskan dengan lebar halaman
fitWindow=Paskan dengan Jendela
flipH=Balik Horisontal
flipV=Balik Vertikal
fontColor=Warna font
fontFamily=Kumpulan font
fontSize=Ukuran font
format=Format
forum=Forum Diskusi/Bantuan
fromTemplate=Dari Templat
fromText=Dari Teks
general=Umum
global=Global
gradient=Gradien
gradientColor=Warna
grid=Kisi
group=Buat Grup
guides=Panduan
hateApp=I hate draw.io
height=Tinggi
help=Bantuan
helpTranslate=Bantu kami menerjemahkan aplikasi ini
hide=Sembunyi
home=Beranda
horizontal=Horisontal
horizontalFlow=Alur Horisontal
horizontalTree=Pohon Horisontal
image=Gambar
images=Gambar-gambar
inline=Sebaris
import=Impor
invalidOrMissingFile=File tidak valid atau hilang
italic=Miring
landscape=Lansekap
layout=Susunan
left=Kiri
leftAlign=Rata Kiri
line=Garis
lineend=Garis Awal
linestart=Garis Akhir
linewidth=Lebar garis
loading=Memuat
loveApp=I love draw.io
manual=Manual
middle=Pertengahan
moreResults=Hasil Lainnya
moreShapes=Bentuk Lainnya
move=Pindah
navigation=Navigasi
new=Baru
noColor=Tidak ada warna
noFiles=Tidak ada file
noMoreResults=Tidak Ada Hasil Lain
none=Tidak ada
noResultsFor=Tidak ada hasil untuk '{1}'
north=Utara
notConnected=Tidak tersambung
ok=OK
opacity=Opasitas
open=Buka
openArrow=Panah Terbuka
openFile=Buka file
openLink=Buka tautan
openInNewWindow=Buka di jendela baru
openSupported=Format didukung adalah file .XML yang disimpan dari software ini
options=Opsi
organic=Organik
orthogonal=Ortogonal
oval=Oval
pages=Halaman-Halaman
pageView=Tampilan Halaman
pageSetup=Pengaturan Halaman
pageScale=Skala Halaman
pan=Pan
paperSize=Ukuran Kertas
paste=Sisip
perimeter=Perimeter
plain=Polos
position=Posisi
posterPrint=Cetak Poster
preview=Pracetak
print=Cetak
readOnly=Read-only
reconnecting=Menghubungi kembali
redo=Ulangi
removeFromGroup=Hapus dari grup
removeWaypoint=Remove waypoint
rename=Rename
renamed=Renamed
renaming=Renaming
replace={1} sudah ada. Anda ingin menimpanya?
replaceExistingDrawing=Hapus gambar yang ada
reset=Setel Ulang
resize=Ubah ukuran
retryingIn=Retrying in {1} second(s)
retryingLoad=Load failed. Retrying...
retryingLogin=Login time out. Retrying...
right=Kanan
rightAlign=Rata Kanan
rotate=Putar
rotation=Rotasi
rounded=Bulat
save=Simpan
saveAs=Simpan Sebagai
saved=Tersimpan
saving=Menyimpan
scrollbars=Baris Gulung
search=Cari
selectAll=Pilih Semua
selectEdges=Pilih Tepi
selectFont=Pilih font
selectVertices=Pilih Simpul
sendMessage=Send
sessionTimeoutOnSave=Your session has timed out and you have been disconnected from the Google Drive. Press OK to login and save. 
setAsDefaultEdge=Setel sebagai tepi standar
shadow=Bayangan
shape=Bentuk
share=Bagikan
shareLink=Tautan untuk editan bersama
sharingServerNotice=Catatan: Fitur eksperimental. Risiko tidak ditanggung!
sharingServerReady=Server bersama siap.
sharingServerUnavailable=Server bersama tidak tersedia.
signOut=Sign out
size=Ukuran
sourceSpacing=Spasi Sumber
south=Selatan
spacing=Spasi
straight=Lurus
strokeColor=Warna Garis
style=Gaya
support=Support
targetSpacing=Spasi Target
text=Teks
textAlignment=Perataan Teks
textOpacity=Opasitas Teks
tilt=Tilt
toBack=Ke Belakang
toFront=Ke Depan
tooltips=Tooltip
top=Atas
topAlign=Rata Atas
transparent=Transparan
underline=Garis Bawah
undo=Batal
ungroup=Lepas Grup
updatingDocument=Memperbarui Dokumen. Silakan tunggu...
updatingSelection=Memperbarui Pilihan. Silakan tunggu...
url=URL
userLoggedOut=Sesi anda telah berakhir. Silakan log in ke Google Account anda untuk menyimpan data.
vertical=Vertikal
verticalFlow=Arus Vertikal
verticalTree=Pohon Vertikal
view=Tampilan
west=Barat
width=Lebar
wordWrap=Word wrap
zoom=Zoom
zoomIn=Perbesar
zoomOut=Perkecil
