# *DO NOT DIRECTLY EDIT THIS FILE, IT IS AUTOMATICALLY GENERATED AND IT IS BASED ON:*
# https://docs.google.com/spreadsheet/ccc?key=0AmQEO36liL4FdDJLWVNMaVV2UmRKSnpXU09MYkdGbEE
aboutDrawio=O draw.io
access_denied=Odmówiono dostępu
actualSize=Rzeczywisty rozmiar
addToExistingDrawing=Dodaj do istniejącego rysunku
addWaypoint=Add waypoint
align=Wyjustuj
alignment=Wyjustowanie
allChangesLost=Wszystkie zmiany zostaną utracone!
alreadyConnected=Węzły zostały już połączone.
apply=Zastosuj
arrange=Rozmieść
appNotInstalledAlert=Aplikacja nie jest zainstalowana. Proszę zainstaluj draw.io z Chrome Web Store i spróbuj ponownie.
appNotInstalledStatus=Aplikacja nie jest zainstalowana.
arrow=Strzałka
arrows=Strzałki
automatic=Automatic
autosize=Automatycznie dopasuj rozmiar
backgroundColor=Kolor tła
basic=Podstawowy
blankDrawing=Nowy rysunek
block=Blokada
bold=Pogrubienie
borderColor=Kolor ramki
borderWidth=Szerokość ramki
bottom=Dół
bottomAlign=Dół
cancel=Anuluj
center=Środek
cannotLoad=Nie udało się załadować. Spróbuj później.
cannotLogin=Nie udało się zalogować. Spróbuj później.
changeOrientation=Zmień kierunek
chatJoined={1} has joined
chatLeft={1} has left
chatWindowTitle=Chat
circle=Kolisty
classic=Klasyczny
clipart=Klipart
close=Zamknij
collapse=Zmniejsz
collapse-expand=Zwiń/Rozwiń
connect=Łącz
connecting=Łączę
connectWithDrive=Połącz z Dyskiem Google
connection=Połączenie
containsValidationErrors=Zawiera błędy potwierdzenia.
copy=Kopiuj
copyConnect=Łącz kopiując
copyOfDrawing=Kopia z rysunku
curved=Curved
custom=Dopasuj
cut=Wytnij
dashed=Przerywana
delete=Usuń
diamond=Diament
diamondThin=Diament (cienki)
didYouKnow=Czy wiesz...
direction=Kierunek
done=Gotowe
doubleClickOrientation=Kliknij dwa razy, aby zmienić kierunek
drawing=Rysunek{1}
drawingEmpty=Rysunek jest pusty
drawingTooLarge=Rysunek jest zbyt duży
duplicate=Zduplikuj
east=Wschód
edit=Edytuj
editLink=Edytuj hiperłącze
embed=Osadź
embedNotice=Dołącz notatkę
enterGroup=Wejdź w grupę
enterValue=Wprowadź wartość
entityRelation=Związek encji
error=Błąd
errorLoadingFile=Błąd ładowania pliku
errorRenamingFile=Error renaming file.
errorRenamingFileNotFound=Error renaming file. File was not found.
errorRenamingFileForbidden=Error renaming file. Insufficient access rights.
errorSavingFile=Błąd zapisywania pliku
errorSavingFileForbidden=Error saving file. Insufficient access rights.
errorSavingFileNotFound=Error saving file. File was not found.
exitGroup=Wyjdź z grupy
expand=Rozszerz
export=Eksportuj
failedToSaveTryReconnect=Błąd zapisu, próbuję połączyć ponownie
featureRequest=Zgłoś nową funkcję
feedback=Wsparcie
file=Plik
filename=Nazwa pliku
fileNotFound=Plik nie znaleziono
fileNotLoaded=Plik nie załadowano
fileNotSaved=Plik nie zapisany
fileOpenLocation=Jak chcesz otworzyć ten plik/te pliki?
fillColor=Kolor wypełnienia
fit=Dopasuj
fitPage=Widok strony
fitPageWidth=Dopasuj szerokość strony
fitWindow=Widok okna
flipH=Odbij poziomo
flipV=Odbij pionowo
fontColor=Kolor czcionki
fontFamily=Rodzaj czcionki
fontSize=Wielkość czcionki
format=Format
forum=Dyskusja/Forum wsparcia
fromTemplate=Z szablonu
fromText=Z tekstu
general=Główny
global=Globalny
gradient=Cieniowanie
gradientColor=Kolor
grid=Siatka
group=Łącz w grupę
guides=Przewodnik
hateApp=Nie lubię draw.io
height=Długość
help=Pomoc
helpTranslate=Pomóż nam przetłumaczyć tę aplikację
hide=Ukryj
home=Początek
horizontal=Poziome
horizontalFlow=Poziomy przepływ
horizontalTree=Poziome drzewo
image=Obraz
images=Obrazy
inline=Wetnij
import=Zaimportuj
invalidOrMissingFile=Nieprawidłowy lub brakujący plik
italic=Kursywa
landscape=Widok
layout=Układ
left=Lewa
leftAlign=Lewa
line=Linia
lineend=Koniec linii
linestart=Początek linii
linewidth=Szerokość linii
loading=Ładuję
loveApp=Kocham draw.io
manual=Manual
middle=Środek
moreResults=Więcej wyników
moreShapes=Więcej kształtów
move=Przemieść
navigation=Nawigacja
new=Nowy
noColor=Bezbarwny
noFiles=Brak plików
noMoreResults=Nie ma więcej wyników
none=Żaden
noResultsFor=Brak wyników dla '{1}'
north=Północ
notConnected=Nie połączony
ok=OK
opacity=Przeźroczystość
open=Otwórz
openArrow=Otwarty
openFile=Otwórz plik
openLink=Otwórz hiperłącze
openInNewWindow=Otwórz w nowym oknie
openSupported=Wspierany jest format XML utworzony tylko z tego programu
options=Opcje
organic=Organiczny
orthogonal=Prostokątny
oval=Owalny
pages=Strona
pageView=Układ strony
pageSetup=Ustawienia strony
pageScale=Skalowanie strony
pan=Panorama
paperSize=Rozmiar papieru
paste=Wklej
perimeter=Granica
plain=Zwykłe
position=Pozycja
posterPrint=Drukuj plakat
preview=Podgląd
print=Drukuj
readOnly=Read-only
reconnecting=Łączę ponownie
redo=Powtórz
removeFromGroup=Usuń z grupy
removeWaypoint=Remove waypoint
rename=Rename
renamed=Renamed
renaming=Renaming
replace={1} już istnieje. Chcesz go zastąpić?
replaceExistingDrawing=Zastąp istniejący rysunek
reset=Czyść
resize=Zmień rozmiar
retryingIn=Ponawiam w ciągu {1} sekund/y
retryingLoad=Błąd ładowania. Ponawiam...
retryingLogin=Błąd logowania. Ponawiam...
right=Prawa
rightAlign=Prawa
rotate=Obrót
rotation=Obróć
rounded=Okrągły
save=Zapisz
saveAs=Zapisz jako
saved=Zapisany
saving=Zapisuję
scrollbars=Pasek przesuwania
search=Szukaj
selectAll=Zaznacz wszystko
selectEdges=Zaznacz brzegi
selectFont=Wybierz czcionkę
selectVertices=Zaznacz wierzchołki
sendMessage=Send
sessionTimeoutOnSave=Twoja sesja wygasła i zostałeś odłączony od Dysku Google. Wciśnij OK by się zalogować i zapisać rysunek.
setAsDefaultEdge=Ustaw jako domyślną krawędź
shadow=Cień
shape=Kształt
share=Udostępnij
shareLink=Udostępnij hiperłącze
sharingServerNotice=Uwaga: Funkcjonalność eksperymentalna. Używaj na własne ryzyko.
sharingServerReady=Serwer udostępniania jest gotowy.
sharingServerUnavailable=Serwer udostępniania jest nieosiągalny.
signOut=Wyloguj
size=Rozmiar
sourceSpacing=Rozmieszczenie źródła
south=Południe
spacing=Rozmieszczenie
straight=Proste
strokeColor=Kolor podkreślenia
style=Styl
support=Support
targetSpacing=Rozmieszczenie celu
text=Tekst
textAlignment=Wyjustowanie tekstu
textOpacity=Nieprzejrzystość tekstu
tilt=Tilt
toBack=Do tyłu
toFront=Do przodu
tooltips=Podpowiedzi
top=Góra
topAlign=Góra
transparent=Przeźroczysty
underline=Podkreślenie
undo=Cofnij
ungroup=Podziel grupę
updatingDocument=Trwa aktualizowanie dokumentu. Proszę czekać...
updatingSelection=Trwa aktualizowanie wyboru. Proszę czekać...
url=URL
userLoggedOut=Twoja sesja się zakończyła. Jeśli chcesz zapisać swoją pracę zaloguj się na konto Google 
vertical=Pionowe
verticalFlow=Pionowy przepływ
verticalTree=Pionowe drzewo
view=Widok
west=Zachód
width=Szerokość
wordWrap=Word wrap
zoom=Widok
zoomIn=Przybliż
zoomOut=Oddal
