# *DO NOT DIRECTLY EDIT THIS FILE, IT IS AUTOMATICALLY GENERATED AND IT IS BASED ON:*
# https://docs.google.com/spreadsheet/ccc?key=0AmQEO36liL4FdDJLWVNMaVV2UmRKSnpXU09MYkdGbEE
aboutDrawio=Over draw.io
access_denied=Toegang geweigerd
actualSize=Origineel Formaat
addToExistingDrawing=Toevoegen aan bestaande tekening
addWaypoint=Add waypoint
align=In lijn brengen
alignment=Uitlijnen
allChangesLost=Alle veranderingen zullen verloren gaan!
alreadyConnected=Knooppunten reeds verbonden
apply=Toepassen
arrange=Rangschikken
appNotInstalledAlert=De app is niet geïnstalleerd. Installeer draw.io in de Chrome Web Store en probeer het opnieuw.
appNotInstalledStatus=App is niet geïnstalleerd.
arrow=Pijl
arrows=Pijlen
automatic=Automatic
autosize=Automatisch Formaat
backgroundColor=Achtergrondkleur
basic=Basis
blankDrawing=Lege tekening
block=Blok
bold=Vet
borderColor=Randkleur
borderWidth=Randbreedte
bottom=Beneden
bottomAlign=Beneden uitlijnen
cancel=Annuleren
center=Centreren
cannotLoad=Load attempts failed. Please try again later.
cannotLogin=Log in attempts failed. Please try again later.
changeOrientation=Verander Richting
chatJoined={1} has joined
chatLeft={1} has left
chatWindowTitle=Chat
circle=Cirkel
classic=Klassiek
clipart=Beeldbibliotheek
close=Sluiten
collapse=Verkleinen
collapse-expand=Verkleinen/Vergroten
connect=Verbinden
connecting=Bezig te verbinden
connectWithDrive=Verbinden met Google Drive
connection=Verbinding
containsValidationErrors=Bevat validatiefouten
copy=Kopiëren
copyConnect=Copy on connect
copyOfDrawing=Kopie van tekening
curved=Curved
custom=Aanpassen
cut=Knippen
dashed=Gestreept
delete=Verwijderen
diamond=Diamand
diamondThin=Diamand (dun)
didYouKnow=Wist u dat...
direction=Richting
done=Voltooid
doubleClickOrientation=Dubbelklik om richting te veranderen
drawing=Tekening{1}
drawingEmpty=Tekening is leeg
drawingTooLarge=Tekening is te groot
duplicate=Dupliceren
east=Oost
edit=Bewerken
editLink=Link bewerken
embed=Embed
embedNotice=Voeg dit eenmaal toe aan het einde van de pagina
enterGroup=Deelnemen aan groep
enterValue=Waarde invullen
entityRelation=Entiteit Relatie
error=Foutmelding
errorLoadingFile=Fout bij het laden van het bestand
errorRenamingFile=Error renaming file.
errorRenamingFileNotFound=Error renaming file. File was not found.
errorRenamingFileForbidden=Error renaming file. Insufficient access rights.
errorSavingFile=Fout bij het opslaan van het bestand
errorSavingFileForbidden=Error saving file. Insufficient access rights.
errorSavingFileNotFound=Error saving file. File was not found.
exitGroup=Groep verlaten
expand=Vergroten
export=Exporteren
failedToSaveTryReconnect=Opslaan mislukt, er wordt geprobeerd opnieuw te verbinden
featureRequest=Feature Request
feedback=Feedback
file=Bestand
filename=Bestandsnaam
fileNotFound=Bestand niet gevonden
fileNotLoaded=Bestand niet geladen
fileNotSaved=Bestand niet opgeslagen
fileOpenLocation=How would you like to open these file(s)?
fillColor=Kleur Vullen
fit=Aanpassen
fitPage=Pagina aanpassen
fitPageWidth=Paginabreedte aanpassen
fitWindow=Venster Passend Maken
flipH=Horizontaal kantelen
flipV=Verticaal kantelen
fontColor=Font Kleur
fontFamily=Font-family
fontSize=Lettergrootte
format=Formatteren
forum=Discussie-/Helpforums
fromTemplate=Van sjabloon
fromText=Van tekst
general=Algemeen
global=Globaal
gradient=Kleurverloop
gradientColor=Kleur
grid=Raster
group=Groeperen
guides=Handleidingen
hateApp=I hate draw.io
height=Hoogte
help=Help
helpTranslate=Help ons deze applicatie te vertalen
hide=Verbergen
home=Home
horizontal=Horizontaal
horizontalFlow=Horizontale stroom
horizontalTree=Horizontale boom
image=Afbeelding
images=Afbeeldingen
inline=Inline
import=Importeren
invalidOrMissingFile=Onjuist of niet gevonden bestand
italic=Cursief
landscape=Liggend
layout=Lay-out
left=Links
leftAlign=Links uitlijnen
line=Lijn
lineend=Lijn Eind
linestart=Lijn Start
linewidth=Lijnbreedte
loading=Bezig met laden
loveApp=I love draw.io
manual=Manual
middle=Midden
moreResults=Meer resultaten
moreShapes=Meer vormen
move=Verplaatsen
navigation=Navigatie
new=Nieuw
noColor=Geen kleur
noFiles=Geen bestanden
noMoreResults=Geen resultaten meer
none=Geen
noResultsFor=Geen resultaten voor '{1}'
north=Noord
notConnected=Geen verbinding
ok=OK
opacity=Opaciteit
open=Openen
openArrow=Openen
openFile=Bestand Openen
openLink=Link openen
openInNewWindow=Openen in nieuw venster
openSupported=Ondersteund formaat zijn .XML-bestanden opgeslagen met deze software
options=Opties
organic=Organisch
orthogonal=Orthogonaal
oval=Ovaal
pages=Pagina's
pageView=Pagina Indeling
pageSetup=Pagina configureren
pageScale=Pagina schalen
pan=Pan
paperSize=Formaat papier
paste=Plakken
perimeter=Perimeter
plain=Normaal
position=Positie
posterPrint=Poster Afdrukken
preview=Voorbeeld
print=Afdrukken
readOnly=Read-only
reconnecting=Bezig met opnieuw te verbinden
redo=Herhalen
removeFromGroup=Verwijderen uit Groep
removeWaypoint=Remove waypoint
rename=Rename
renamed=Renamed
renaming=Renaming
replace=Bestaat al. Wilt u het overschrijven?
replaceExistingDrawing=Bestaande tekening vervangen
reset=Opnieuw instellen
resize=Grootte aanpassen
retryingIn=Retrying in {1} second(s)
retryingLoad=Load failed. Retrying...
retryingLogin=Login time out. Retrying...
right=Rechts
rightAlign=Rechts uitlijnen
rotate=Roteren
rotation=Rotatie
rounded=Afgerond
save=Bewaren
saveAs=Bewaren Als
saved=Opgeslagen
saving=Bezig met opslaan
scrollbars=Schuifbalken
search=Zoeken
selectAll=Alles Selecteren
selectEdges=Selecteer Randen
selectFont=Selecteer Lettertype
selectVertices=Selecteer Hoekpunten
sendMessage=Send
sessionTimeoutOnSave=Your session has timed out and you have been disconnected from the Google Drive. Press OK to login and save. 
setAsDefaultEdge=Instellen als standaard rand
shadow=Schaduw
shape=Vorm
share=Delen
shareLink=Link voor gedeeld bewerken
sharingServerNotice=Let op: Experimentele functie. Gebruik is op eigen risico!
sharingServerReady=Server delen is gereed.
sharingServerUnavailable=Server delen is niet beschikbaar.
signOut=Afmelden
size=Formaat
sourceSpacing=Bron Interlinie
south=Zuid
spacing=Interlinie
straight=Recht
strokeColor=Lijn Kleur
style=Stijl
support=Support
targetSpacing=Doel Interlinie
text=Tekst
textAlignment=Tekst Uitlijnen
textOpacity=Tekst Opaciteit
tilt=Tilt
toBack=Naar Achter Plaatsen
toFront=Naar Voren Plaatsen
tooltips=Tooltips
top=Boven
topAlign=Boven uitlijnen
transparent=Transparant
underline=Onderstrepen
undo=Ongedaan Maken
ungroup=Degroeperen
updatingDocument=Document wordt bijgewerkt. Een ogenblik aub...
updatingSelection=Selectie wordt bijgewerkt. Een ogenblik aub...
url=URL
userLoggedOut=Uw sessie is beëindigd. Om niet opgeslagen werk op te slaan, dient u zich aan te melden bij uw Google Account als 
vertical=Verticaal
verticalFlow=Verticale stroom
verticalTree=Verticale boom
view=Bekijken
west=West
width=Breedte
wordWrap=Word wrap
zoom=Zoom
zoomIn=Vergroten
zoomOut=Verkleinen
