# *DO NOT DIRECTLY EDIT THIS FILE, IT IS AUTOMATICALLY GENERATED AND IT IS BASED ON:*
# https://docs.google.com/spreadsheet/ccc?key=0AmQEO36liL4FdDJLWVNMaVV2UmRKSnpXU09MYkdGbEE
aboutDrawio=idraw.io에 대하어
access_denied=접근 거부
actualSize=실제 크기
addToExistingDrawing=기존 그림에 추가
addWaypoint=Add waypoint
align=정렬
alignment=정렬
allChangesLost=모든 변경 분실
alreadyConnected=이미 연결됨
apply=적용
arrange=배열
appNotInstalledAlert=에플리케이션 설치 않됨 알림
appNotInstalledStatus=에플리케이션 설치 않됨   
arrow=화살표
arrows=화살표
automatic=Automatic
autosize=자동 조정
backgroundColor=바탕색상
basic=기본
blankDrawing=곰백 그리기
block=블록
bold=볼드
borderColor=보더 색상
borderWidth=보더 폭
bottom=맨 아래로
bottomAlign=맨아래로  정렬
cancel=취소
center=중앙
cannotLoad=Load attempts failed. Please try again later.
cannotLogin=Log in attempts failed. Please try again later.
changeOrientation=방향 바꾸기
chatJoined={1} has joined
chatLeft={1} has left
chatWindowTitle=Chat
circle=원형
classic=클래식
clipart=클립아트
close=종료
collapse=닫기
collapse-expand=닫기/확대
connect=접속    
connecting=접속중
connectWithDrive=Connect with Google Drive
connection=연결
containsValidationErrors=오류 확인 포함
copy=복사
copyConnect=Copy on connect
copyOfDrawing=드로잉 복사
curved=Curved
custom=주문
cut=축소시키기
dashed=점선
delete=삭제
diamond=다이아몬드
diamondThin=다이아몬드(얇은)
didYouKnow=알고계세요…
direction=방향   
done=완료
doubleClickOrientation=방향을 바꾸려면 더블 클릭
drawing=그리기 (1)
drawingEmpty=그리기 비어있음
drawingTooLarge=그리기 너무 큼
duplicate=복사
east=동쪽
edit=편집
editLink=링크 편집
embed=삽입
embedNotice=삽입 알림
enterGroup=그룹 입력
enterValue=값을 입력
entityRelation=실체 관계
error=오류 
errorLoadingFile=로딩 파일 오류 
errorRenamingFile=Error renaming file.
errorRenamingFileNotFound=Error renaming file. File was not found.
errorRenamingFileForbidden=Error renaming file. Insufficient access rights.
errorSavingFile=저장 파일 오류
errorSavingFileForbidden=Error saving file. Insufficient access rights.
errorSavingFileNotFound=Error saving file. File was not found.
exitGroup=그룹 나가기
expand=확대
export=보내기
failedToSaveTryReconnect=저장 실패, 재접속중
featureRequest=Feature Request
feedback=Feedback
file=파일
filename=파일 이름
fileNotFound=파일 무존재
fileNotLoaded=파일 전송 않됨
fileNotSaved=파일  저장 않됨
fileOpenLocation=How would you like to open these file(s)?
fillColor=색상 채우기
fit=설치
fitPage=한 페이지
fitPageWidth=페이지 폭
fitWindow=창에 맞추기
flipH=가로로 뒤집기
flipV=세로로 뒤집기
fontColor=글자채 색상
fontFamily=글자채
fontSize=글자 크기
format=포멧
forum=검토/도움 포럼
fromTemplate=템플렛
fromText=텍스트에서
general=보편적
global=종합적
gradient=그라디에이션
gradientColor=색상
grid=그리드
group=그룹
guides=안내
hateApp=I hate draw.io
height=높이
help=도움
helpTranslate=도움 번역하기
hide=감추기
home=홈
horizontal=가로   
horizontalFlow=가로 흐름
horizontalTree=가로 트리 그림
image=이미지
images=이미지
inline=인라인
import=가져오기
invalidOrMissingFile=잘못된 또는 분실 파일
italic=이탈릭
landscape=가로
layout=배열
left=왼쪽
leftAlign=왼쪽 정렬
line=라인
lineend=라인 종료
linestart=라인 시작
linewidth=라인 폭
loading=로딩    
loveApp=I love draw.io
manual=Manual
middle=중앙
moreResults=추가 결과
moreShapes=추가 모양
move=이동
navigation=내비게이션
new=신규
noColor=무 색상
noFiles=파일 없음
noMoreResults=결과 없음
none=없음
noResultsFor=(1) 의 결과 없음
north=북쪽
notConnected=연결 않됨
ok=OK
opacity=불투명도
open=열기
openArrow=화살표 열기
openFile=파일 열기
openLink=링크 열기
openInNewWindow=새 윈도우 열기
openSupported=개방형 지원
options=옵숀
organic=유기적
orthogonal=직교
oval=타원형
pages=페이지
pageView=페이지 뷰
pageSetup=페이지 셋 업
pageScale=페이지 스케일
pan=팬
paperSize=용지 크기
paste=붙이기
perimeter=경계
plain=일반
position=포지션
posterPrint=포스터 프린트
preview=미리보기
print=프린트
readOnly=Read-only
reconnecting=재 접속중
redo=다시하기
removeFromGroup=그룹에서 제거
removeWaypoint=Remove waypoint
rename=Rename
renamed=Renamed
renaming=Renaming
replace=대체하기
replaceExistingDrawing=기존 드로잉 교체
reset=리셋
resize=크기조절
retryingIn=Retrying in {1} second(s)
retryingLoad=Load failed. Retrying...
retryingLogin=Login time out. Retrying...
right=오른쪽
rightAlign=오른쪽 정렬
rotate=회전
rotation=회전
rounded=원형
save=저장
saveAs=다른이름으로 저장
saved=저장됨
saving=저장중
scrollbars=스크롤바
search=검색
selectAll=모든것 선택
selectEdges=끝 선택
selectFont=글자체 선택
selectVertices=세로 선택
sendMessage=Send
sessionTimeoutOnSave=Your session has timed out and you have been disconnected from the Google Drive. Press OK to login and save. 
setAsDefaultEdge=디폴트 에지로 설정
shadow=음영
shape=모양
share=공유
shareLink=공유 편집 링크
sharingServerNotice=공유 서버 알림
sharingServerReady=공유 서버 완료
sharingServerUnavailable=공유 서버 사용불가
signOut=서명
size=사이즈
sourceSpacing=소스 간격
south=남쪽
spacing=간격
straight=스트레이트
strokeColor=줄 색상
style=스타일
support=Support
targetSpacing=타겟 간격
text=문자
textAlignment=문자 정렬
textOpacity=문자 불투명함
tilt=Tilt
toBack=뒤로
toFront=앞으로
tooltips=툴팁
top=맨위로
topAlign=맨위로 맞추기
transparent=투과적
underline=밑줄
undo=취소
ungroup=그룹 취소
updatingDocument=다큐먼트 업데이트중
updatingSelection=선택 업데이틍중
url=URL
userLoggedOut=사용자 로그 오프
vertical=버티컬
verticalFlow=세로 흐름
verticalTree=세로 트리그림
view=뷰
west=서쪽
width=폭
wordWrap=Word wrap
zoom=줌
zoomIn=확대
zoomOut=축소 
