# *DO NOT DIRECTLY EDIT THIS FILE, IT IS AUTOMATICALLY GENERATED AND IT IS BASED ON:*
# https://docs.google.com/spreadsheet/ccc?key=0AmQEO36liL4FdDJLWVNMaVV2UmRKSnpXU09MYkdGbEE
aboutDrawio=О draw.io
access_denied=Доступ заборонено
actualSize=Фактичний розмір
addToExistingDrawing=Додати до існуючого документу
addWaypoint=Add waypoint
align=Вирівняти
alignment=Вирівнювання
allChangesLost=Усі зміни будуть втрачені
alreadyConnected=Вузли вже підключені
apply=Застосувати
arrange=Впорядкувати
appNotInstalledAlert=Програма не встановлена. Будь ласка, встановіть програму draw.io у Chrome Web Storeта спробуйте ще раз.
appNotInstalledStatus=Програма не встановлена.
arrow=Стрілка
arrows=Стрілки
automatic=Automatic
autosize=Авторозмір
backgroundColor=Колір фону
basic=Основний
blankDrawing=Новий малюнок
block=Блокувати
bold=Напівжирний
borderColor=Колір границі
borderWidth=Ширина границі
bottom=По нижньому краю
bottomAlign=Вирівняти по нижньому краю
cancel=Скасувати
center=Відцентрувати
cannotLoad=Load attempts failed. Please try again later.
cannotLogin=Log in attempts failed. Please try again later.
changeOrientation=Змінити напрямок
chatJoined={1} has joined
chatLeft={1} has left
chatWindowTitle=Chat
circle=Круг
classic=Класичний
clipart=Малюнок
close=Закрити
collapse=Згорнути
collapse-expand=Згорнути/Розгорнути
connect=З'єднати
connecting=З'єднує
connectWithDrive=Connect with Google Drive
connection=З'єднання
containsValidationErrors=Містить помилки підтвердження
copy=Копіювати
copyConnect=Copy on connect
copyOfDrawing=Копія документа
curved=Curved
custom=Налаштувати
cut=Вирізати
dashed=Пуктир
delete=Видалити
diamond=Ромб
diamondThin=Ромб (тонкий)
didYouKnow=Ви знали...
direction=Напрям
done=Готово
doubleClickOrientation=Двічу клацніть мишкою, щоб змінити напрям
drawing=Малюнок{1}
drawingEmpty=Малюнок порожній
drawingTooLarge=Малюнок надто великий
duplicate=Дублювати
east=Схід
edit=Редагувати
editLink=Редагувати посилання
embed=Вставити
embedNotice=Додати 1 раз у кінці сторінки
enterGroup=Увійти до групи
enterValue=Введіть значення
entityRelation=Існування залежності
error=Помилка
errorLoadingFile=Помилка при завантаженні файла
errorRenamingFile=Error renaming file.
errorRenamingFileNotFound=Error renaming file. File was not found.
errorRenamingFileForbidden=Error renaming file. Insufficient access rights.
errorSavingFile=Помилка при зберіганні файла
errorSavingFileForbidden=Error saving file. Insufficient access rights.
errorSavingFileNotFound=Error saving file. File was not found.
exitGroup=Вийти із групи
expand=Розгорнути
export=Експортувати
failedToSaveTryReconnect=Не вдалося зберегти, спроба повторного підключення
featureRequest=Feature Request
feedback=Feedback
file=Файл
filename=Ім'я файлу
fileNotFound=Файл не знайдено
fileNotLoaded=Файл не завантажено
fileNotSaved=Файл не збережено
fileOpenLocation=How would you like to open these file(s)?
fillColor=Колір заливки
fit=По розміру
fitPage=Одна сторінка
fitPageWidth=Ширина сторінки
fitWindow=По розміру вікна
flipH=Відобразити зліва направо
flipV=Відобразити зверху донизу
fontColor=Колір тексту
fontFamily=Сімейство шрифтів
fontSize=Розмір шрифту
format=Формат
forum=Обговорення/Довідковий форум
fromTemplate=З шаблону
fromText=З тексту
general=Загальний
global=Глобальний
gradient=Похил
gradientColor=Колір
grid=Сітка
group=Група
guides=Посібники
hateApp=I hate draw.io
height=Висоти
help=Допомогти
helpTranslate=Допоможіть нам перекласти цю програму
hide=Сховати
home=Домашня сторінка
horizontal=Горизонтальний
horizontalFlow=Горизонтальний потік
horizontalTree=Горизонтальне дерево
image=Малюнок
images=Малюнки
inline=Вбудований
import=Імпорт
invalidOrMissingFile=Файл невірний або відсутній
italic=Курсив
landscape=Альбомний
layout=Макет
left=Зліва
leftAlign=Вирівнювання по лівому краю
line=Лінія
lineend=Кінець стрілки
linestart=Початок стрілки
linewidth=Товщина лінії
loading=Завантаження
loveApp=I love draw.io
manual=Manual
middle=Посередині
moreResults=Додаткові результати
moreShapes=Додаткові форми
move=Переміщати
navigation=Навігація
new=Новий
noColor=Немає кольору
noFiles=Немає файлів
noMoreResults=Інші результати відсутні
none=Нічого
noResultsFor=Немає результатів для'{1}'
north=Північ
notConnected=Немає зв'язку
ok=Добре
opacity=Непрозорість
open=Відкрити
openArrow=Відкрита стрілка
openFile=Відкрити файл
openLink=Відкрити посилання
openInNewWindow=Відкрити нове вікно
openSupported=Підтримується формат .XML-файлів, збережених за допомогою цього програмного забезпечення
options=Параметри
organic=Органічний
orthogonal=Прямокутний
oval=Овальний
pages=Сторінки
pageView=Перегляд сторінки
pageSetup=Налаштування сторінки
pageScale=Масштаб сторінки
pan=Прокрутка
paperSize=Розмір паперу
paste=Вставити
perimeter=По периметру
plain=Простий
position=Положення
posterPrint=Багосторінкове роздрукування постеру
preview=Попередній перегляд
print=Роздрукувати
readOnly=Read-only
reconnecting=Повторне підключення
redo=Повторити
removeFromGroup=Видалити із групи
removeWaypoint=Remove waypoint
rename=Rename
renamed=Renamed
renaming=Renaming
replace={1} вже існує. Ви хочете замінити його?
replaceExistingDrawing=Замінити існуючий документ
reset=Відрегулювати
resize=Змінити розмір
retryingIn=Retrying in {1} second(s)
retryingLoad=Load failed. Retrying...
retryingLogin=Login time out. Retrying...
right=Право
rightAlign=Вирівнювання по правому краю
rotate=Обертати
rotation=Обертання
rounded=Закруглений
save=Зберегти
saveAs=Зберегти як
saved=Збережено
saving=Збереження
scrollbars=Прокручування
search=Пошук
selectAll=Вибрати все
selectEdges=Вибрати сторони
selectFont=Вибрати шрифт
selectVertices=Вибрати вершини
sendMessage=Send
sessionTimeoutOnSave=Your session has timed out and you have been disconnected from the Google Drive. Press OK to login and save. 
setAsDefaultEdge=Встановити край за умовчуванням
shadow=Тінь
shape=Формат
share=Розділити
shareLink=Посилання для спільного редагування
sharingServerNotice=Примітка: Експериментальна функція. Використовуйте на свій страх і ризик!
sharingServerReady=Сервер для обміну готовий.
sharingServerUnavailable=Сервер для обміну недоступний.
signOut=Вийти
size=Розмір
sourceSpacing=Від початкового вузла
south=Південь
spacing=Інтервали
straight=Прямий
strokeColor=Колір лінії
style=Стиль
support=Support
targetSpacing=Від кінцевого вузла
text=Текст
textAlignment=Вирівнювання тексту
textOpacity=Непрозорість тексту
tilt=Tilt
toBack=На задній план
toFront=На передній план
tooltips=Підказки
top=Верх
topAlign=По верхньому краю
transparent=Прозорий
underline=Підкреслений
undo=Відмінити
ungroup=Розгрупувати
updatingDocument=Документ оновлюється. Будь ласка, зачекайте...
updatingSelection=Вибір оновлюється. Будь ласка, зачекайте...
url=URL-адреса
userLoggedOut=Сеанс вашої роботи закінчився. Задля збререження будь-якої незбереженої інформації, Вам потрібно увійти до свого облікового запису Google як
vertical=Вертикальний
verticalFlow=Вертикальний потік
verticalTree=Вертикальне дерево
view=Оглянути
west=Захід
width=Ширина
wordWrap=Word wrap
zoom=Масштаб
zoomIn=Збільшити
zoomOut=Зменшити
