# *DO NOT DIRECTLY EDIT THIS FILE, IT IS AUTOMATICALLY GENERATED AND IT IS BASED ON:*
# https://docs.google.com/spreadsheet/ccc?key=0AmQEO36liL4FdDJLWVNMaVV2UmRKSnpXU09MYkdGbEE
aboutDrawio=Sobre draw.io
access_denied=Acesso negado
actualSize=Tamanho Real 
addToExistingDrawing=Adicionar ao desenho existente
addWaypoint=Add waypoint
align=Alinhar 
alignment=Alinhamento
allChangesLost=Todas as modificações serão perdidas! 
alreadyConnected=Nodos já conectados 
apply=Aplicar
arrange=Ordenar
appNotInstalledAlert=App não instalada. Por gentileza, instale draw.io da Chrome Web Store e tente outra vez.
appNotInstalledStatus=App não instalada.
arrow=Seta
arrows=Setas
automatic=Automatic
autosize=Auto Dimensionar 
backgroundColor=Cor do fundo
basic=Básico
blankDrawing=Desenho em branco
block=Bloco 
bold=Negrito 
borderColor=Cor da borda 
borderWidth=Largura da borda
bottom=Fundo
bottomAlign=Fundo
cancel=Cancelar 
center=Centro 
cannotLoad=Load attempts failed. Please try again later.
cannotLogin=Log in attempts failed. Please try again later.
changeOrientation=Modificar Orientação
chatJoined={1} has joined
chatLeft={1} has left
chatWindowTitle=Chat
circle=Círculo
classic=Clássica
clipart=Clipart
close=Fechar 
collapse=Recolher
collapse-expand=Recolher/Expandir
connect=Conetar
connecting=Conetando
connectWithDrive=Conete-se com Google Drive
connection=Conexão 
containsValidationErrors=Contém erros de validação 
copy=Copiar
copyConnect=Copy on connect
copyOfDrawing=Cópia do Desenho
curved=Curved
custom=Personalizado
cut=Cortar 
dashed=Tracejado 
delete=Apagar
diamond=Diamante
diamondThin=Diamante (Fino)
didYouKnow=Você sabia...
direction=Direção 
done=Concluído
doubleClickOrientation=Clique duas vezes para mudar de orientação 
drawing=Desenho{1}
drawingEmpty=Desenho está vazio
drawingTooLarge=O desenho é muito grande 
duplicate=Duplicado
east=Este
edit=Editar 
editLink=Editar ligação
embed=Embutir
embedNotice=Adicionar isto, uma vez, no fim da página
enterGroup=Digitar grupo
enterValue=Digite o valor 
entityRelation=Relação Entidades
error=Erro 
errorLoadingFile=Erro ao carregar o arquivo
errorRenamingFile=Error renaming file.
errorRenamingFileNotFound=Error renaming file. File was not found.
errorRenamingFileForbidden=Error renaming file. Insufficient access rights.
errorSavingFile=Erro ao salvar o arquivo
errorSavingFileForbidden=Error saving file. Insufficient access rights.
errorSavingFileNotFound=Error saving file. File was not found.
exitGroup=Sair do Grupo
expand=Expandir
export=Exportar
failedToSaveTryReconnect=Falha ao salvar, tentando reconetar
featureRequest=Feature Request
feedback=Feedback
file=Arquivo 
filename=Nome do arquivo
fileNotFound=Arquivo não encontrado
fileNotLoaded=Arquivo não carregado
fileNotSaved=Arquivo não salvo
fileOpenLocation=How would you like to open these file(s)?
fillColor=Cor de preenchimento 
fit=Ajustar
fitPage=Ajustar página
fitPageWidth=Ajustar largura da página
fitWindow=Ajustar Janela 
flipH=Virar horizontal
flipV=Virar vertical
fontColor=Cor da fonte 
fontFamily=Família fonte
fontSize=Tamanho da fonte
format=Formatar
forum=Fóruns Discussão/Ajuda
fromTemplate=Do Modelo
fromText=Do Texto
general=Geral
global=Global 
gradient=Gradiente
gradientColor=Cor
grid=Grelha
group=Agrupar
guides=Guias
hateApp=I hate draw.io
height=Altura 
help=Ajuda 
helpTranslate=Nos ajude a traduzir este aplicativo
hide=Ocultar 
home=Página Inicial
horizontal=Horizontal 
horizontalFlow=Fluxo Horizontal
horizontalTree=Árvore Horizontal
image=Imagem
images=Imagens
inline=Em linha
import=Importar
invalidOrMissingFile=Arquivo inválido ou em falta
italic=Itálico 
landscape=Paisagem 
layout=Traçado
left=Esquerda 
leftAlign=Esquerda 
line=Linha 
lineend=Fim da Linha
linestart=Início da Linha
linewidth=Largura da Linha
loading=Carregando...
loveApp=I love draw.io
manual=Manual
middle=Meio
moreResults=Mais resultados
moreShapes=Mais Formas
move=Mover
navigation=Navegação
new=Novo 
noColor=Sem cor
noFiles=Nenhum arquivo
noMoreResults=Sem mais resultados
none=Nenhum 
noResultsFor=Sem resultados para '{1}'
north=Norte 
notConnected=Não conetado
ok=OK 
opacity=Opacidade 
open=Abrir 
openArrow=Aberta 
openFile=Abrir Arquivo 
openLink=Abrir ligação
openInNewWindow=Abrir numa outra janela
openSupported=Formato suportado é arquivo .XML salvos deste software
options=Opções
organic=Orgánico
orthogonal=Ortogonal
oval=Oval 
pages=Páginas
pageView=Layout da Página 
pageSetup=Configuração da Página
pageScale=Escala da Página
pan=Panorama
paperSize=Tamanho Papel 
paste=Colar 
perimeter=Perímetro 
plain=Plana
position=Posição 
posterPrint=Imprimir Cartaz 
preview=Pré-visualizar 
print=Imprimir 
readOnly=Read-only
reconnecting=Reconetando
redo=Refazer 
removeFromGroup=Retirar do Grupo 
removeWaypoint=Remove waypoint
rename=Rename
renamed=Renamed
renaming=Renaming
replace={1} já existe. Você deseja substituí-lo? 
replaceExistingDrawing=Substituir desenho já existente
reset=Reset
resize=Redimensionar
retryingIn=Retrying in {1} second(s)
retryingLoad=Load failed. Retrying...
retryingLogin=Login time out. Retrying...
right=Direita 
rightAlign=Direita 
rotate=Rodar
rotation=Rotação 
rounded=Arredondado 
save=Salvar
saveAs=Salvar como
saved=Salvo
saving=Salvando
scrollbars=Barras de Rolagem
search=Buscar
selectAll=Selecionar Tudo 
selectEdges=Selecione Bordas 
selectFont=Selecione uma fonte 
selectVertices=Selecione Vértices 
sendMessage=Send
sessionTimeoutOnSave=Your session has timed out and you have been disconnected from the Google Drive. Press OK to login and save. 
setAsDefaultEdge=Definir como borda padrão
shadow=Sombra
shape=Forma 
share=Partilhar
shareLink=Ligação para editar partilhado
sharingServerNotice=Nota: Recurso Experimental. Use por sua conta e risco!
sharingServerReady=Servidor de compartilhamento está pronto.
sharingServerUnavailable=Servidor de compartilhamento está indisponível.
signOut=Sair
size=Tamanho 
sourceSpacing=Espaçamento Fonte
south=Sul
spacing=Espaçamento 
straight=Recta
strokeColor=Cor da linha 
style=Estilo 
support=Support
targetSpacing=Espaçamento Alvo
text=Texto
textAlignment=Alinhamento de texto 
textOpacity=Opacidade do Texto
tilt=Tilt
toBack=Para Trás 
toFront=Para a Frente 
tooltips=Dicas Ferramenta
top=Topo
topAlign=Topo
transparent=Transparente
underline=Sublinhado 
undo=Desfazer 
ungroup=Desagrupar 
updatingDocument=Atualizando Documento. Por favor, aguarde... 
updatingSelection=Atualizando Seleção. Por favor, aguarde... 
url=URL
userLoggedOut=Sua sessão foi encerrada. Para salvar qualquer trabalho não salvo você tem que entrar na sua conta Google como
vertical=Vertical 
verticalFlow=Fluxo Vertical
verticalTree=Árvore Vertical
view=Visualização
west=Oeste
width=Largura 
wordWrap=Word wrap
zoom=Zoom 
zoomIn=Mais Zoom 
zoomOut=Menos Zoom 
