# *DO NOT DIRECTLY EDIT THIS FILE, IT IS AUTOMATICALLY GENERATED AND IT IS BASED ON:*
# https://docs.google.com/spreadsheet/ccc?key=0AmQEO36liL4FdDJLWVNMaVV2UmRKSnpXU09MYkdGbEE
aboutDrawio=Om draw.io
access_denied=Tilgang nektet
actualSize=Faktisk størrelse
addToExistingDrawing=Legge til eksisterende tegning
addWaypoint=Add waypoint
align=Justere
alignment=Justering
allChangesLost=Alle endringer vil gå tapt
alreadyConnected=Noder er allerede forbundet
apply=Bruk
arrange=Arranger
appNotInstalledAlert=App er ikke installert. Vennligst installer draw.io i Chrome Web Store og prøv igjen.
appNotInstalledStatus=App er ikke installert. 
arrow=Pil
arrows=Piler
automatic=Automatic
autosize=Automatisk størrelse
backgroundColor=Bakgrunnfarge
basic=Grunnlegende
blankDrawing=Blank tegning
block=Blokk
bold=Fet
borderColor=Kantfarge
borderWidth=Kantbredde
bottom=Bunn
bottomAlign=Juster til bunn
cancel=Annuler
center=Sentrer
cannotLoad=Lasting feilet. Vennligst forsøk igjen senere.
cannotLogin=Innlogging feilet. Vennligst forsøk igjen senere.
changeOrientation=Skift orientering
chatJoined={1} has joined
chatLeft={1} has left
chatWindowTitle=Chat
circle=Sirkel
classic=Klassisk
clipart=Bildebibliotek
close=Lukk
collapse=Reduser
collapse-expand=Reduser/utvid
connect=Koble til
connecting=Kobler til
connectWithDrive=Koble til Google Drive
connection=Forbindelse
containsValidationErrors=Inneholder valideringsfeil
copy=Kopier
copyConnect=Kopier ved sammenkobling
copyOfDrawing=Kopi av tegning
curved=Curved
custom=Tilpasset
cut=Klipp
dashed=Stiplet
delete=Slett
diamond=Diamant
diamondThin=Diamant (tynn)
didYouKnow=Visste du at...
direction=Retning
done=Utført
doubleClickOrientation=Dobbelklikk for å endre orientering
drawing=Tegning
drawingEmpty=Tegningen er tom
drawingTooLarge=Tegningen er for stor
duplicate=Dupliser
east=Øst
edit=Rediger
editLink=Rediger lenke
embed=Integrer
embedNotice=Legge til dette en gang på sluten av siden
enterGroup=Tast inn gruppe
enterValue=Tast inn verdi
entityRelation=Enhetsrelasjon
error=Feil
errorLoadingFile=Feil ved innlasting av fil
errorRenamingFile=Error renaming file.
errorRenamingFileNotFound=Error renaming file. File was not found.
errorRenamingFileForbidden=Error renaming file. Insufficient access rights.
errorSavingFile=Feil ved lagring av fil
errorSavingFileForbidden=Error saving file. Insufficient access rights.
errorSavingFileNotFound=Error saving file. File was not found.
exitGroup=Avslutt gruppe
expand=Utvid
export=Eksport
failedToSaveTryReconnect=Feil under lagring, prøver å koble til igjen
featureRequest=Funksjonsforespørsel
feedback=Tilbakemelding
file=Fil
filename=Filnavn
fileNotFound=Filen ble ikke funnet
fileNotLoaded=Filen ble ikke lastet
fileNotSaved=Filen ble ikke lagret
fileOpenLocation=Hvordan ønsker du å åpne filen(e)?
fillColor=Fyll farge
fit=Tilpass
fitPage=Tilpass side
fitPageWidth=Tilpass sidebredde
fitWindow=Tilpass vindu
flipH=Vend horisontalt
flipV=Vend vertikalt
fontColor=Skriftfarge
fontFamily=Skriftfamilie
fontSize=Skriftstørrelse
format=Format
forum=Diskusjon/Hjelpeforumer
fromTemplate=Fra mal
fromText=Fra tekst
general=Generell
global=Global
gradient=Gradient
gradientColor=Farge
grid=Rutenett
group=Grupper
guides=Veileder
hateApp=Jeg hater draw.io
height=Høyde
help=Hjelp
helpTranslate=Hjelp oss å oversette denne appen
hide=Skjul
home=Hjem
horizontal=Horisontal
horizontalFlow=Horisontal flyt
horizontalTree=Horisontalt tre
image=Bilde
images=Bilder
inline=Inline
import=Importer
invalidOrMissingFile=Ugyldig eller manglende fil
italic=Kursiv
landscape=Landskap
layout=Layout
left=Venstre
leftAlign=Venstrejustering
line=Linje
lineend=Linjeavslutning
linestart=Linjestart
linewidth=Linjebredde
loading=Laster
loveApp=Jeg elsker draw.io
manual=Manual
middle=Midt
moreResults=Flere treff
moreShapes=Flere former
move=Flytt
navigation=Navigasjon
new=Ny
noColor=Ingen farge
noFiles=Ingen filer
noMoreResults=Ingen flere treff
none=Ingen
noResultsFor=Ingen treff for '{1}'
north=Nord
notConnected=Ikke tilkoblet
ok=OK
opacity=Gjennomsiktighet
open=Åpen
openArrow=Åpen pil
openFile=Åpen fil
openLink=Åpen lenke
openInNewWindow=Åpne i nytt vindu
openSupported=Støttede format er .XML-filer lagret fra denne programvare
options=Alternativer
organic=Organisk
orthogonal=Ortogonale
oval=Oval
pages=Sider
pageView=Sidevisning
pageSetup=Sideoppsett
pageScale=Sideskalering
pan=Panorer
paperSize=Papirstørrelse
paste=Lim inn
perimeter=Utkant
plain=Normal
position=Posisjon
posterPrint=Plakatutskrift
preview=Forhåndsvisning
print=Skriv ut
readOnly=Read-only
reconnecting=Kobler til på nytt
redo=Gjør om
removeFromGroup=Fjern fra gruppe
removeWaypoint=Remove waypoint
rename=Rename
renamed=Renamed
renaming=Renaming
replace={1} finnes fra før. Vil du erstatte den?
replaceExistingDrawing=Erstatt eksisterende tegning
reset=Tilbakestill
resize=Omgjør størrelse
retryingIn=Forsøker igjen om {1} sekund(er)
retryingLoad=Lasting feilet. Forsøker på nytt...
retryingLogin=Login timeout. Forsøker på nytt...
right=Høyre
rightAlign=Høyrejustering
rotate=Roter
rotation=Rotasjon
rounded=Avrundet
save=Lagre
saveAs=Lagre som
saved=Lagret
saving=Lagrer
scrollbars=Rullefelt
search=Søk
selectAll=Velg alt
selectEdges=Velg kanter
selectFont=Velg skrifttype
selectVertices=Velg toppunkter
sendMessage=Send
sessionTimeoutOnSave=Sessjonen din har timet ut og du har mistet forbindelsen til Google Drive. Trykk på OK for å logge inn på nytt og lagre arbeidet.
setAsDefaultEdge=Sett som standard kant
shadow=Skygge
shape=Form
share=Del
shareLink=Lenke til felles redigering
sharingServerNotice=Bemerk: Eksperimentell funksjon. Bruk på eget ansvar!
sharingServerReady=Delingsserver er klar.
sharingServerUnavailable=Delingsserver er ikke tilgjengelig.
signOut=Logg ut
size=Størrelse
sourceSpacing=Kildeavstand
south=Syd
spacing=Avstand
straight=Rett
strokeColor=Linjefarge
style=Stil
support=Support
targetSpacing=Målavstand
text=Tekst
textAlignment=Tekstjustering
textOpacity=Tekstgjennomsiktighet
tilt=Tilt
toBack=Til baksiden
toFront=Til forsiden
tooltips=Verktøytips
top=Topp
topAlign=Toppjustering
transparent=Gjennomsiktig
underline=Understreke
undo=Angre
ungroup=Del opp gruppe
updatingDocument=Oppdaterer dokument. Vennligst vent...
updatingSelection=Oppdaterer utvalg. Vennligst vent...
url=URL
userLoggedOut=Din session er avsluttet. For å lagre må du logge på din Google konto som
vertical=Vertikal
verticalFlow=Vertikal flyt
verticalTree=Vertikalt tre
view=Vis
west=Vest
width=Bredde
wordWrap=Word wrap
zoom=Zoom
zoomIn=Zoom inn
zoomOut=Zoom ut
